Release	Brand
Avengers: Endgame	Marvel Comics
Black Panther	Marvel Comics
Avengers: Infinity War	Marvel Comics
The Avengers	Marvel Comics
Avengers: Age of Ultron	Marvel Comics
Captain Marvel	Marvel Comics
Iron Man 3	Marvel Comics
Captain America: Civil War	Marvel Comics
Spider-Man	Marvel Comics
Spider-Man: Far from Home	Marvel Comics
Guardians of the Galaxy Vol. 2	Marvel Comics
Spider-Man 2	Marvel Comics
Deadpool	Marvel Comics
Spider-Man 3	Marvel Comics
Spider-Man: Homecoming	Marvel Comics
Guardians of the Galaxy	Marvel Comics
Iron Man	Marvel Comics
Deadpool 2	Marvel Comics
Thor: Ragnarok	Marvel Comics
Iron Man 2	Marvel Comics
The Amazing Spider-Man	Marvel Comics
Captain America: The Winter Soldier	Marvel Comics
X-Men: The Last Stand	Marvel Comics
X-Men: Days of Future Past	Marvel Comics
Doctor Strange	Marvel Comics
Logan	Marvel Comics
Big Hero 6	Marvel Comics
Ant-Man and the Wasp	Marvel Comics
X2: X-Men United	Marvel Comics
Venom	Marvel Comics
Thor: The Dark World	Marvel Comics
The Amazing Spider-Man 2	Marvel Comics
Spider-Man: Into the Spider-Verse	Marvel Comics
Thor	Marvel Comics
Ant-Man	Marvel Comics
X-Men Origins: Wolverine	Marvel Comics
Captain America: The First Avenger	Marvel Comics
X-Men	Marvel Comics
X-Men: Apocalypse	Marvel Comics
Fantastic Four	Marvel Comics
X-Men: First Class	Marvel Comics
The Incredible Hulk	Marvel Comics
The Wolverine	Marvel Comics
Hulk	Marvel Comics
Fantastic 4: Rise of the Silver Surfer	Marvel Comics
Ghost Rider	Marvel Comics
Daredevil	Marvel Comics
Blade II	Marvel Comics
Blade	Marvel Comics
X-Men: Dark Phoenix	Marvel Comics
Fantastic Four	Marvel Comics
Blade: Trinity	Marvel Comics
Ghost Rider: Spirit of Vengeance	Marvel Comics
The Punisher	Marvel Comics
Elektra	Marvel Comics
The New Mutants	Marvel Comics
Howard the Duck	Marvel Comics
Punisher: War Zone	Marvel Comics
Spider-Man/Men in Black IIDouble Bill	Marvel Comics
Once Upon a Deadpool2018 Re-release	Marvel Comics
Inhumans	Marvel Comics
Iron Man2020 Re-release	Marvel Comics
Black Panther2020 Re-release	Marvel Comics
Jurassic World	Legendary Pictures
The Dark Knight	Legendary Pictures
The Dark Knight Rises	Legendary Pictures
Jurassic World: Fallen Kingdom	Legendary Pictures
Inception	Legendary Pictures
Man of Steel	Legendary Pictures
The Hangover	Legendary Pictures
The Hangover Part II	Legendary Pictures
300	Legendary Pictures
Batman Begins	Legendary Pictures
Godzilla	Legendary Pictures
Superman Returns	Legendary Pictures
Interstellar	Legendary Pictures
Kong: Skull Island	Legendary Pictures
Clash of the Titans	Legendary Pictures
Straight Outta Compton	Legendary Pictures
Pokémon Detective Pikachu	Legendary Pictures
Mamma Mia! Here We Go Again	Legendary Pictures
Unbroken	Legendary Pictures
The Hangover Part III	Legendary Pictures
Godzilla: King of the Monsters	Legendary Pictures
Watchmen	Legendary Pictures
300: Rise of an Empire	Legendary Pictures
Pacific Rim	Legendary Pictures
Due Date	Legendary Pictures
42	Legendary Pictures
10,000 BC	Legendary Pictures
The Town	Legendary Pictures
Wrath of the Titans	Legendary Pictures
Where the Wild Things Are	Legendary Pictures
Skyscraper	Legendary Pictures
Jack the Giant Slayer	Legendary Pictures
Pacific Rim: Uprising	Legendary Pictures
Dracula Untold	Legendary Pictures
BlacKkKlansman	Legendary Pictures
Warcraft	Legendary Pictures
The Great Wall	Legendary Pictures
We Are Marshall	Legendary Pictures
Krampus	Legendary Pictures
Lady in the Water	Legendary Pictures
Ninja Assassin	Legendary Pictures
Sucker Punch	Legendary Pictures
Crimson Peak	Legendary Pictures
The Ant Bully	Legendary Pictures
Observe and Report	Legendary Pictures
As Above, So Below	Legendary Pictures
Beerfest	Legendary Pictures
Steve Jobs	Legendary Pictures
Seventh Son	Legendary Pictures
Mortal Engines	Legendary Pictures
Jonah Hex	Legendary Pictures
Blackhat	Legendary Pictures
The Dark Knight2012 Re-release	Legendary Pictures
Batman Begins2012 Re-release	Legendary Pictures
The Dark Knight2018 Re-release	Legendary Pictures
Star Wars: Episode VII - The Force Awakens	Lucasfilm
Star Wars: Episode VIII - The Last Jedi	Lucasfilm
Rogue One: A Star Wars Story	Lucasfilm
Star Wars: Episode IX - The Rise of Skywalker	Lucasfilm
Star Wars: Episode I - The Phantom Menace	Lucasfilm
Star Wars: Episode III - Revenge of the Sith	Lucasfilm
Indiana Jones and the Kingdom of the Crystal Skull	Lucasfilm
Star Wars: Episode IV - A New Hope	Lucasfilm
Star Wars: Episode II - Attack of the Clones	Lucasfilm
Star Wars: Episode VI - Return of the Jedi	Lucasfilm
Solo: A Star Wars Story	Lucasfilm
Raiders of the Lost Ark	Lucasfilm
Star Wars: Episode V - The Empire Strikes Back	Lucasfilm
Indiana Jones and the Last Crusade	Lucasfilm
Indiana Jones and the Temple of Doom	Lucasfilm
Star Wars: Episode IV - A New Hope1997 Special Edition	Lucasfilm
American Graffiti	Lucasfilm
Star Wars: Episode V - The Empire Strikes Back1997 Special Edition	Lucasfilm
Willow	Lucasfilm
Red Tails	Lucasfilm
Star Wars: Episode VI - Return of the Jedi1997 Special Edition	Lucasfilm
Star Wars: Episode I - The Phantom Menace2012 3D Release	Lucasfilm
Star Wars: The Clone Wars	Lucasfilm
Raiders of the Lost Ark1982 Re-release	Lucasfilm
Tucker: The Man and His Dream	Lucasfilm
Howard the Duck	Lucasfilm
Star Wars: Episode IV - A New Hope1982 Re-release	Lucasfilm
More American Graffiti	Lucasfilm
Star Wars: Episode V - The Empire Strikes Back1982 Re-release	Lucasfilm
Labyrinth	Lucasfilm
Strange Magic	Lucasfilm
Raiders of the Lost Ark1983 Re-release	Lucasfilm
Star Wars: Episode VI - Return of the Jedi1985 Re-release	Lucasfilm
Star Wars: Episode II - Attack of the Clones2002 IMAX Release	Lucasfilm
Raiders of the Lost Ark2012 IMAX Release	Lucasfilm
Star Wars: Episode V - The Empire Strikes Back2020 Re-release	Lucasfilm
Radioland Murders	Lucasfilm
Labyrinth2018 Re-release	Lucasfilm
Mishima: A Life in Four Chapters	Lucasfilm
Incredibles 2	Pixar
Finding Dory	Pixar
Toy Story 4	Pixar
Toy Story 3	Pixar
Inside Out	Pixar
Finding Nemo	Pixar
Up	Pixar
Monsters University	Pixar
The Incredibles	Pixar
Monsters, Inc.	Pixar
Toy Story 2	Pixar
Cars	Pixar
Brave	Pixar
WALL·E	Pixar
Coco	Pixar
Ratatouille	Pixar
Toy Story	Pixar
Cars 2	Pixar
A Bug's Life	Pixar
Cars 3	Pixar
The Good Dinosaur	Pixar
Onward	Pixar
Finding Nemo2012 3D Release	Pixar
Monsters, Inc.2012 3D Release	Pixar
Toy Story2009 Re-release	Pixar
Monsters, Inc.2020 Re-release	Pixar
Inside Out2020 Re-release	Pixar
The Dark Knight	DC Comics
The Dark Knight Rises	DC Comics
Wonder Woman	DC Comics
Joker	DC Comics
Aquaman	DC Comics
Batman v Superman: Dawn of Justice	DC Comics
Suicide Squad	DC Comics
Man of Steel	DC Comics
Batman	DC Comics
Justice League	DC Comics
Batman Begins	DC Comics
Superman Returns	DC Comics
Batman Forever	DC Comics
The Lego Batman Movie	DC Comics
Batman Returns	DC Comics
Shazam!	DC Comics
Superman	DC Comics
Green Lantern	DC Comics
Superman II	DC Comics
Watchmen	DC Comics
Batman & Robin	DC Comics
RED	DC Comics
Birds of Prey: And the Fantabulous Emancipation of One Harley Quinn	DC Comics
Constantine	DC Comics
V for Vendetta	DC Comics
Superman III	DC Comics
RED 2	DC Comics
Catwoman	DC Comics
Teen Titans GO! To the Movies	DC Comics
The Losers	DC Comics
Superman IV: The Quest for Peace	DC Comics
Supergirl	DC Comics
Jonah Hex	DC Comics
Batman: Mask of the Phantasm	DC Comics
Steel	DC Comics
The Dark Knight2012 Re-release	DC Comics
Batman Begins2012 Re-release	DC Comics
The Dark Knight2018 Re-release	DC Comics
Superman2018 Re-release	DC Comics
Batman2019 Re-release	DC Comics
Batman Returns2019 Re-release	DC Comics
Batman Forever2019 Re-release	DC Comics
Batman & Robin2019 Re-release	DC Comics
Batman: Mask of the Phantasm2018 Re-release	DC Comics
Shrek 2	DreamWorks Animation
Shrek the Third	DreamWorks Animation
Shrek	DreamWorks Animation
Shrek Forever After	DreamWorks Animation
How to Train Your Dragon	DreamWorks Animation
Madagascar 3: Europe's Most Wanted	DreamWorks Animation
Kung Fu Panda	DreamWorks Animation
Monsters vs. Aliens	DreamWorks Animation
Madagascar	DreamWorks Animation
The Croods	DreamWorks Animation
Madagascar: Escape 2 Africa	DreamWorks Animation
Home	DreamWorks Animation
How to Train Your Dragon 2	DreamWorks Animation
The Boss Baby	DreamWorks Animation
Kung Fu Panda 2	DreamWorks Animation
Shark Tale	DreamWorks Animation
How to Train Your Dragon: The Hidden World	DreamWorks Animation
Over the Hedge	DreamWorks Animation
Trolls	DreamWorks Animation
Puss in Boots	DreamWorks Animation
Megamind	DreamWorks Animation
Kung Fu Panda 3	DreamWorks Animation
Bee Movie	DreamWorks Animation
Mr. Peabody & Sherman	DreamWorks Animation
Chicken Run	DreamWorks Animation
Rise of the Guardians	DreamWorks Animation
The Prince of Egypt	DreamWorks Animation
Antz	DreamWorks Animation
Penguins of Madagascar	DreamWorks Animation
Turbo	DreamWorks Animation
Captain Underpants: The First Epic Movie	DreamWorks Animation
Spirit: Stallion of the Cimarron	DreamWorks Animation
Flushed Away	DreamWorks Animation
Abominable	DreamWorks Animation
Wallace & Gromit: The Curse of the Were-Rabbit	DreamWorks Animation
The Road to El Dorado	DreamWorks Animation
Sinbad: Legend of the Seven Seas	DreamWorks Animation
Star Wars: Episode VII - The Force Awakens	Bad Robot
Star Wars: Episode IX - The Rise of Skywalker	Bad Robot
Star Trek	Bad Robot
Star Trek Into Darkness	Bad Robot
Mission: Impossible - Fallout	Bad Robot
Mission: Impossible - Ghost Protocol	Bad Robot
Mission: Impossible - Rogue Nation	Bad Robot
Star Trek Beyond	Bad Robot
Super 8	Bad Robot
Cloverfield	Bad Robot
10 Cloverfield Lane	Bad Robot
Morning Glory	Bad Robot
Joy Ride	Bad Robot
Overlord	Bad Robot
Infinitely Polar Bear	Bad Robot
It	Vertigo Entertainment
The Lego Movie	Vertigo Entertainment
How to Train Your Dragon	Vertigo Entertainment
It Chapter Two	Vertigo Entertainment
How to Train Your Dragon 2	Vertigo Entertainment
The Lego Batman Movie	Vertigo Entertainment
How to Train Your Dragon: The Hidden World	Vertigo Entertainment
The Departed	Vertigo Entertainment
The Ring	Vertigo Entertainment
Godzilla: King of the Monsters	Vertigo Entertainment
The Grudge	Vertigo Entertainment
The LEGO Movie 2: The Second Part	Vertigo Entertainment
Eight Below	Vertigo Entertainment
The Ring Two	Vertigo Entertainment
The Lego Ninjago Movie	Vertigo Entertainment
The Woman in Black	Vertigo Entertainment
The Strangers	Vertigo Entertainment
The Lake House	Vertigo Entertainment
Poltergeist	Vertigo Entertainment
The Grudge 2	Vertigo Entertainment
The Roommate	Vertigo Entertainment
The Boy	Vertigo Entertainment
Quarantine	Vertigo Entertainment
Doctor Sleep	Vertigo Entertainment
The Eye	Vertigo Entertainment
The Uninvited	Vertigo Entertainment
Abduction	Vertigo Entertainment
Rings	Vertigo Entertainment
The Woman in Black 2: Angel of Death	Vertigo Entertainment
Run All Night	Vertigo Entertainment
Shutter	Vertigo Entertainment
Dark Water2005 Re-release	Vertigo Entertainment
The Grudge	Vertigo Entertainment
The Disaster Artist	Vertigo Entertainment
Sleepless	Vertigo Entertainment
Blair Witch	Vertigo Entertainment
The Turning	Vertigo Entertainment
The Invasion	Vertigo Entertainment
Oldboy	Vertigo Entertainment
It2019 Re-release	Vertigo Entertainment
Frozen II	Walt Disney Animation Studios
Frozen	Walt Disney Animation Studios
Zootopia	Walt Disney Animation Studios
Moana	Walt Disney Animation Studios
Big Hero 6	Walt Disney Animation Studios
Ralph Breaks the Internet	Walt Disney Animation Studios
Tangled	Walt Disney Animation Studios
Wreck-It Ralph	Walt Disney Animation Studios
Bolt	Walt Disney Animation Studios
The Princess and the Frog	Walt Disney Animation Studios
Meet the Robinsons	Walt Disney Animation Studios
Winnie the Pooh	Walt Disney Animation Studios
The Secret Life of Pets	Illumination Entertainment
Despicable Me 2	Illumination Entertainment
Minions	Illumination Entertainment
Dr. Seuss' the Grinch	Illumination Entertainment
Sing	Illumination Entertainment
Despicable Me 3	Illumination Entertainment
Despicable Me	Illumination Entertainment
The Lorax	Illumination Entertainment
The Secret Life of Pets 2	Illumination Entertainment
Hop	Illumination Entertainment
Get Out	Blumhouse Productions
Halloween	Blumhouse Productions
Split	Blumhouse Productions
Glass	Blumhouse Productions
Paranormal Activity	Blumhouse Productions
Paranormal Activity 3	Blumhouse Productions
Paranormal Activity 2	Blumhouse Productions
Insidious: Chapter 2	Blumhouse Productions
The Purge: Election Year	Blumhouse Productions
The Purge: Anarchy	Blumhouse Productions
The First Purge	Blumhouse Productions
Insidious: The Last Key	Blumhouse Productions
The Visit	Blumhouse Productions
The Invisible Man	Blumhouse Productions
The Purge	Blumhouse Productions
Happy Death Day	Blumhouse Productions
Insidious	Blumhouse Productions
Paranormal Activity 4	Blumhouse Productions
Insidious: Chapter 3	Blumhouse Productions
Ouija	Blumhouse Productions
BlacKkKlansman	Blumhouse Productions
Sinister	Blumhouse Productions
Ma	Blumhouse Productions
The Gift	Blumhouse Productions
Truth or Dare	Blumhouse Productions
The Boy Next Door	Blumhouse Productions
Ouija: Origin of Evil	Blumhouse Productions
Unfriended	Blumhouse Productions
Paranormal Activity: The Marked Ones	Blumhouse Productions
Happy Death Day 2U	Blumhouse Productions
Sinister 2	Blumhouse Productions
Fantasy Island	Blumhouse Productions
The Lazarus Effect	Blumhouse Productions
The Gallows	Blumhouse Productions
Paranormal Activity: The Ghost Dimension	Blumhouse Productions
Dark Skies	Blumhouse Productions
Whiplash	Blumhouse Productions
The Darkness	Blumhouse Productions
Black Christmas	Blumhouse Productions
Birth of the Dragon	Blumhouse Productions
Lowriders	Blumhouse Productions
Don't Let Go	Blumhouse Productions
Incarnate	Blumhouse Productions
Sleight	Blumhouse Productions
Jem and the Holograms	Blumhouse Productions
Be Here Now	Blumhouse Productions
Amityville: The Awakening	Blumhouse Productions
Transformers: Revenge of the Fallen	Hasbro
Transformers: Dark of the Moon	Hasbro
Transformers	Hasbro
Transformers: Age of Extinction	Hasbro
G.I. Joe: The Rise of Cobra	Hasbro
Transformers: The Last Knight	Hasbro
Bumblebee	Hasbro
G.I. Joe: Retaliation	Hasbro
Battleship	Hasbro
Ouija	Hasbro
Ouija: Origin of Evil	Hasbro
My Little Pony: The Movie	Hasbro
Clue	Hasbro
My Little Pony: The Movie	Hasbro
The Transformers: The Movie	Hasbro
Jem and the Holograms	Hasbro
Teenage Mutant Ninja Turtles	Nickelodeon
The SpongeBob Movie: Sponge Out of Water	Nickelodeon
The Last Airbender	Nickelodeon
Rango	Nickelodeon
A Series of Unfortunate Events	Nickelodeon
The Rugrats Movie	Nickelodeon
The SpongeBob SquarePants Movie	Nickelodeon
Charlotte's Web	Nickelodeon
Teenage Mutant Ninja Turtles: Out of the Shadows	Nickelodeon
Jimmy Neutron: Boy Genius	Nickelodeon
Nacho Libre	Nickelodeon
Rugrats in Paris	Nickelodeon
Hotel for Dogs	Nickelodeon
Barnyard	Nickelodeon
The Spiderwick Chronicles	Nickelodeon
Dora and the Lost City of Gold	Nickelodeon
Snow Day	Nickelodeon
Yours, Mine & Ours	Nickelodeon
The Wild Thornberrys	Nickelodeon
Rugrats Go Wild	Nickelodeon
Clockstoppers	Nickelodeon
Monster Trucks	Nickelodeon
Harriet the Spy	Nickelodeon
Good Burger	Nickelodeon
Hey Arnold! The Movie	Nickelodeon
Fun Size	Nickelodeon
Spider-Man: Into the Spider-Verse	Sony Pictures Animation
Hotel Transylvania 2	Sony Pictures Animation
Hotel Transylvania 3: Summer Vacation	Sony Pictures Animation
Hotel Transylvania	Sony Pictures Animation
The Smurfs	Sony Pictures Animation
Cloudy with a Chance of Meatballs	Sony Pictures Animation
Cloudy With a Chance of Meatballs 2	Sony Pictures Animation
Peter Rabbit	Sony Pictures Animation
The Angry Birds Movie	Sony Pictures Animation
The Emoji Movie	Sony Pictures Animation
Open Season	Sony Pictures Animation
Goosebumps	Sony Pictures Animation
The Smurfs 2	Sony Pictures Animation
Surf's Up	Sony Pictures Animation
Goosebumps 2: Haunted Halloween	Sony Pictures Animation
Arthur Christmas	Sony Pictures Animation
Smurfs: The Lost Village	Sony Pictures Animation
The Angry Birds Movie 2	Sony Pictures Animation
The Star	Sony Pictures Animation
The Pirates! Band of Misfits	Sony Pictures Animation
The Star2019 Re-release	Sony Pictures Animation
The Chronicles of Narnia: The Lion, the Witch and the Wardrobe	Walden Media
The Chronicles of Narnia: Prince Caspian	Walden Media
Wonder	Walden Media
The Chronicles of Narnia: The Voyage of the Dawn Treader	Walden Media
Journey 2: The Mysterious Island	Walden Media
Journey to the Center of the Earth	Walden Media
Charlotte's Web	Walden Media
Bridge to Terabithia	Walden Media
Parental Guidance	Walden Media
Holes	Walden Media
A Dog's Purpose	Walden Media
Tooth Fairy	Walden Media
The BFG	Walden Media
Nim's Island	Walden Media
The Giver	Walden Media
Everest	Walden Media
The Water Horse	Walden Media
The Star	Walden Media
Because of Winn-Dixie	Walden Media
Mr. Magorium's Wonder Emporium	Walden Media
Ramona and Beezus	Walden Media
Around the World in 80 Days	Walden Media
Monte Carlo	Walden Media
Amazing Grace	Walden Media
Ghosts of the Abyss	Walden Media
How to Eat Fried Worms	Walden Media
Pulse: A Stomp Odyssey	Walden Media
Aliens of the Deep	Walden Media
The Seeker: The Dark Is Rising	Walden Media
Hoot	Walden Media
City of Ember	Walden Media
Waiting for 'Superman'	Walden Media
Chasing Mavericks	Walden Media
Won't Back Down	Walden Media
Bandslam	Walden Media
The Resurrection of Gavin Stone	Walden Media
I Am David	Walden Media
The Star2019 Re-release	Walden Media
Ice Age: Dawn of the Dinosaurs	Blue Sky
Ice Age: The Meltdown	Blue Sky
Ice Age	Blue Sky
Ice Age: Continental Drift	Blue Sky
Horton Hears a Who!	Blue Sky
Rio	Blue Sky
Rio 2	Blue Sky
The Peanuts Movie	Blue Sky
Robots	Blue Sky
Epic	Blue Sky
Ferdinand	Blue Sky
Spies in Disguise	Blue Sky
Ice Age: Collision Course	Blue Sky
It	Stephen King
It Chapter Two	Stephen King
The Green Mile	Stephen King
1408	Stephen King
Misery	Stephen King
Pet Sematary	Stephen King
Pet Sematary	Stephen King
Stand by Me	Stephen King
The Dark Tower	Stephen King
Secret Window	Stephen King
The Shining	Stephen King
The Running Man	Stephen King
Carrie	Stephen King
Carrie	Stephen King
Dreamcatcher	Stephen King
The Lawnmower Man	Stephen King
Doctor Sleep	Stephen King
Sleepwalkers	Stephen King
The Shawshank Redemption	Stephen King
The Mist	Stephen King
Dolores Claiborne	Stephen King
Hearts in Atlantis	Stephen King
Cujo	Stephen King
Creepshow	Stephen King
Christine	Stephen King
The Dead Zone	Stephen King
The Rage: Carrie 2	Stephen King
Pet Sematary II	Stephen King
Firestarter	Stephen King
Tales from the Darkside	Stephen King
Thinner	Stephen King
Needful Things	Stephen King
Children of the Corn	Stephen King
Cat's Eye	Stephen King
Silver Bullet	Stephen King
Graveyard Shift	Stephen King
The Dark Half	Stephen King
Apt Pupil	Stephen King
Maximum Overdrive	Stephen King
Children of the Corn II: The Final Sacrifice	Stephen King
Lawnmower Man 2: Beyond Cyberspace	Stephen King
The Mangler	Stephen King
It2019 Re-release	Stephen King
The Shining2019 Re-release	Stephen King
The Shining2017 Re-release	Stephen King
The Shawshank Redemption2019 Re-release	Stephen King
The Shining2012 Re-release	Stephen King
Riding the Bullet	Stephen King
The Night Flier	Stephen King
The Longest Yard	MTV
Blades of Glory	MTV
Jackass 3D	MTV
Jackass Presents: Bad Grandpa	MTV
Save the Last Dance	MTV
Justin Bieber: Never Say Never	MTV
Jackass Number Two	MTV
Coach Carter	MTV
Jackass: The Movie	MTV
Beavis and Butt-Head Do America	MTV
Varsity Blues	MTV
Footloose2011 Re-release	MTV
Napoleon Dynamite	MTV
Orange County	MTV
The Original Kings of Comedy	MTV
Crossroads	MTV
Freedom Writers	MTV
Get Rich or Die Tryin'	MTV
The Fighting Temptations	MTV
Æon Flux	MTV
Dance Flick	MTV
Katy Perry: Part of Me	MTV
The Wood	MTV
Hustle & Flow	MTV
Martin Lawrence Live: Runteldat	MTV
Dead Man on Campus	MTV
Election	MTV
Stop-Loss	MTV
The Perfect Score	MTV
Tupac: Resurrection	MTV
How She Move	MTV
200 Cigarettes	MTV
Joe's Apartment	MTV
Better Luck Tomorrow	MTV
Pootie Tang	MTV
Murderball	MTV
Teenage Mutant Ninja Turtles	Platinum Dunes
A Quiet Place	Platinum Dunes
Teenage Mutant Ninja Turtles: Out of the Shadows	Platinum Dunes
The Texas Chainsaw Massacre	Platinum Dunes
The Purge: Election Year	Platinum Dunes
The Purge: Anarchy	Platinum Dunes
The Amityville Horror	Platinum Dunes
Friday the 13th	Platinum Dunes
The Purge	Platinum Dunes
A Nightmare on Elm Street	Platinum Dunes
Dora and the Lost City of Gold	Platinum Dunes
Ouija	Platinum Dunes
The Unborn	Platinum Dunes
The Texas Chainsaw Massacre: The Beginning	Platinum Dunes
Ouija: Origin of Evil	Platinum Dunes
Project Almanac	Platinum Dunes
The Hitcher	Platinum Dunes
Bridesmaids	Saturday Night Live - Alumni Debuts
National Lampoon's Animal House	Saturday Night Live - Alumni Debuts
48 Hrs.	Saturday Night Live - Alumni Debuts
Old School	Saturday Night Live - Alumni Debuts
Deuce Bigalow: Male Gigolo	Saturday Night Live - Alumni Debuts
Foul Play	Saturday Night Live - Alumni Debuts
Meatballs	Saturday Night Live - Alumni Debuts
Running Scared	Saturday Night Live - Alumni Debuts
Taxi2004 Re-release	Saturday Night Live - Alumni Debuts
Tommy Boy	Saturday Night Live - Alumni Debuts
Neighbors	Saturday Night Live - Alumni Debuts
Houseguest	Saturday Night Live - Alumni Debuts
Innerspace	Saturday Night Live - Alumni Debuts
Billy Madison	Saturday Night Live - Alumni Debuts
Corky Romano	Saturday Night Live - Alumni Debuts
National Lampoon's Animal House1979 Re-release	Saturday Night Live - Alumni Debuts
High School High	Saturday Night Live - Alumni Debuts
CB4	Saturday Night Live - Alumni Debuts
Half Baked	Saturday Night Live - Alumni Debuts
First Family	Saturday Night Live - Alumni Debuts
Wholly Moses!	Saturday Night Live - Alumni Debuts
Hot Rod	Saturday Night Live - Alumni Debuts
Casual Sex?	Saturday Night Live - Alumni Debuts
So I Married an Axe Murderer	Saturday Night Live - Alumni Debuts
Opportunity Knocks	Saturday Night Live - Alumni Debuts
Dirty Work	Saturday Night Live - Alumni Debuts
How to Beat the High Cost of Living	Saturday Night Live - Alumni Debuts
Lost & Found	Saturday Night Live - Alumni Debuts
Bordello of Blood	Saturday Night Live - Alumni Debuts
Taxi	Saturday Night Live - Alumni Debuts
300	Dark Horse Comics
The Mask	Dark Horse Comics
300: Rise of an Empire	Dark Horse Comics
Alien vs. Predator	Dark Horse Comics
Hellboy II: The Golden Army	Dark Horse Comics
Sin City	Dark Horse Comics
Hellboy	Dark Horse Comics
Timecop	Dark Horse Comics
Aliens vs. Predator: Requiem	Dark Horse Comics
R.I.P.D.	Dark Horse Comics
Mystery Men	Dark Horse Comics
Hellboy	Dark Horse Comics
Son of the Mask	Dark Horse Comics
Virus	Dark Horse Comics
Frank Miller's Sin City: A Dame to Kill For	Dark Horse Comics
Barb Wire	Dark Horse Comics
Alice in Wonderland	Tim Burton-Johnny Depp
Charlie and the Chocolate Factory	Tim Burton-Johnny Depp
Sleepy Hollow	Tim Burton-Johnny Depp
Dark Shadows	Tim Burton-Johnny Depp
Edward Scissorhands	Tim Burton-Johnny Depp
Corpse Bride	Tim Burton-Johnny Depp
Sweeney Todd: The Demon Barber of Fleet Street	Tim Burton-Johnny Depp
Ed Wood	Tim Burton-Johnny Depp
The Lego Movie	Warner Animation Group
The Lego Batman Movie	Warner Animation Group
The LEGO Movie 2: The Second Part	Warner Animation Group
Smallfoot	Warner Animation Group
Storks	Warner Animation Group
The Lego Ninjago Movie	Warner Animation Group
Teen Titans GO! To the Movies	Warner Animation Group
Madea Goes to Jail	Tyler Perry
Madea's Witness Protection	Tyler Perry
Madea's Family Reunion	Tyler Perry
Why Did I Get Married Too?	Tyler Perry
Why Did I Get Married?	Tyler Perry
Tyler Perry's Madea's Big Happy Family	Tyler Perry
Tyler Perry's A Madea Christmas	Tyler Perry
Temptation: Confessions of a Marriage Counselor	Tyler Perry
I Can Do Bad All by Myself	Tyler Perry
Diary of a Mad Black Woman	Tyler Perry
Meet the Browns	Tyler Perry
The Family That Preys	Tyler Perry
Tyler Perry's Good Deeds	Tyler Perry
Daddy's Little Girls	Tyler Perry
The Single Moms Club	Tyler Perry
Peeples	Tyler Perry
Scary Stories to Tell in the Dark	CBS Films
Last Vegas	CBS Films
The Woman in Black	CBS Films
Five Feet Apart	CBS Films
The Back-up Plan	CBS Films
American Assassin	CBS Films
The DUFF	CBS Films
Patriots Day	CBS Films
The Mechanic	CBS Films
Beastly	CBS Films
Hell or High Water	CBS Films
Love the Coopers	CBS Films
Winchester	CBS Films
Faster	CBS Films
Middle School: The Worst Years of My Life	CBS Films
The Last Exorcism 2	CBS Films
Seven Psychopaths	CBS Films
Inside Llewyn Davis	CBS Films
Extraordinary Measures	CBS Films
The Words	CBS Films
Hell Fest	CBS Films
Salmon Fishing in the Yemen	CBS Films
Jexi	CBS Films
The To Do List	CBS Films
Pride	CBS Films
The Kings of Summer	CBS Films
The Sense of an Ending	CBS Films
Dean	CBS Films
Afflicted	CBS Films
The Firm	John Grisham
A Time to Kill	John Grisham
The Pelican Brief	John Grisham
The Client	John Grisham
Christmas with the Kranks	John Grisham
Runaway Jury	John Grisham
The Rainmaker	John Grisham
The Chamber	John Grisham
The Gingerbread Man	John Grisham
Mickey	John Grisham
The Bourne Ultimatum	Robert Ludlum
The Bourne Supremacy	Robert Ludlum
The Bourne Identity	Robert Ludlum
The Bourne Legacy	Robert Ludlum
The Osterman Weekend	Robert Ludlum
The Holcroft Covenant	Robert Ludlum
The Notebook	Nicholas Sparks
Dear John	Nicholas Sparks
Safe Haven	Nicholas Sparks
The Last Song	Nicholas Sparks
The Lucky One	Nicholas Sparks
Message in a Bottle	Nicholas Sparks
Nights in Rodanthe	Nicholas Sparks
A Walk to Remember	Nicholas Sparks
The Longest Ride	Nicholas Sparks
The Best of Me	Nicholas Sparks
The Choice	Nicholas Sparks
Scooby-Doo	Hanna-Barbera
The Flintstones	Hanna-Barbera
Yogi Bear	Hanna-Barbera
Scooby-Doo 2: Monsters Unleashed	Hanna-Barbera
The Flintstones in Viva Rock Vegas	Hanna-Barbera
Jetsons: The Movie	Hanna-Barbera
Tom and Jerry: The Movie	Hanna-Barbera
Hey There, It's Yogi Bear	Hanna-Barbera
Minority Report	Philip K. Dick
Total Recall	Philip K. Dick
The Adjustment Bureau	Philip K. Dick
Total Recall	Philip K. Dick
Paycheck	Philip K. Dick
Blade Runner	Philip K. Dick
Next	Philip K. Dick
Impostor	Philip K. Dick
Screamers	Philip K. Dick
A Scanner Darkly	Philip K. Dick
Blade RunnerThe Final Cut	Philip K. Dick
Blade RunnerThe Final Cut (2007 re-release)	Philip K. Dick
Total Recall2012 Re-release	Philip K. Dick
Radio Free Albemuth	Philip K. Dick
Unknown	Dark Castle
Gothika	Dark Castle
Thir13en Ghosts	Dark Castle
Orphan	Dark Castle
House on Haunted Hill	Dark Castle
Ninja Assassin	Dark Castle
House of Wax	Dark Castle
Ghost Ship	Dark Castle
The Reaping	Dark Castle
The Losers	Dark Castle
Splice2010 Re-release	Dark Castle
Getaway	Dark Castle
Whiteout	Dark Castle
Bullet to the Head	Dark Castle
RocknRolla	Dark Castle
The Apparition	Dark Castle
National Lampoon's Animal House	National Lampoon
National Lampoon's Christmas Vacation	National Lampoon
National Lampoon's Vacation	National Lampoon
National Lampoon's European Vacation	National Lampoon
Vegas Vacation	National Lampoon
Loaded Weapon 1	National Lampoon
National Lampoon's Animal House1979 Re-release	National Lampoon
Van Wilder: Party Liaison	National Lampoon
Class Reunion	National Lampoon
Senior Trip	National Lampoon
Joy of Sex	National Lampoon
Van Wilder 2: The Rise of Taj	National Lampoon
National Lampoon's Christmas Vacation2019 Re-release	National Lampoon
Gold Diggers	National Lampoon
Movie Madness	National Lampoon
Dorm Daze	National Lampoon
Blackball2005 Re-release	National Lampoon
O.C. and Stiggs	National Lampoon
Barely Legal	National Lampoon
High School Musical 3	Disney Channel
Hannah Montana: The Movie	Disney Channel
Hannah Montana and Miley Cyrus: Best of Both Worlds Concert	Disney Channel
The Lizzie McGuire Movie	Disney Channel
Recess: School's Out	Disney Channel
Doug's 1st Movie	Disney Channel
Jonas Brothers: The 3D Concert Experience	Disney Channel
Teacher's Pet	Disney Channel
Charlie and the Chocolate Factory	Roald Dahl
The BFG	Roald Dahl
Matilda	Roald Dahl
James and the Giant Peach	Roald Dahl
Fantastic Mr. Fox	Roald Dahl
The Witches	Roald Dahl
Willy Wonka & the Chocolate Factory2016 Re-release	Roald Dahl
Wayne's World	Saturday Night Live
The Blues Brothers	Saturday Night Live
Wayne's World 2	Saturday Night Live
Superstar	Saturday Night Live
A Night at the Roxbury	Saturday Night Live
Coneheads	Saturday Night Live
Blues Brothers 2000	Saturday Night Live
The Ladies Man	Saturday Night Live
MacGruber	Saturday Night Live
Stuart Saves His Family	Saturday Night Live
It's Pat: The Movie	Saturday Night Live
Planes	DisneyToon Studios
Planes: Fire & Rescue	DisneyToon Studios
The Jungle Book 2	DisneyToon Studios
The Tigger Movie	DisneyToon Studios
A Goofy Movie	DisneyToon Studios
Piglet's Big Movie	DisneyToon Studios
DuckTales the Movie: Treasure of the Lost Lamp	DisneyToon Studios
Pooh's Heffalump Movie	DisneyToon Studios
Chicken Run	Aardman
Flushed Away	Aardman
Wallace & Gromit: The Curse of the Were-Rabbit	Aardman
Arthur Christmas	Aardman
The Pirates! Band of Misfits	Aardman
Shaun the Sheep Movie	Aardman
Early Man	Aardman
Wallace and Grommit Festival	Aardman
Wallace and Grommit Festival	Aardman
Wallace and Grommit Festival	Aardman
Wallace and Grommit Festival	Aardman
Wallace and Grommit Festival	Aardman
Wallace and Grommit Festival	Aardman
Wallace and Grommit Festival	Aardman
Wallace and Grommit Festival	Aardman
Wallace and Grommit Festival	Aardman
Coraline	Laika
ParaNorman	Laika
Corpse Bride	Laika
The Boxtrolls	Laika
Kubo and the Two Strings	Laika
Missing Link	Laika
Watchmen	Alan Moore
V for Vendetta	Alan Moore
The League of Extraordinary Gentlemen	Alan Moore
From Hell	Alan Moore
Manchester by the Sea	Amazon Studios
The Big Sick	Amazon Studios
Late Night	Amazon Studios
Love & Friendship	Amazon Studios
Café Society	Amazon Studios
The Lost City of Z	Amazon Studios
Beautiful Boy	Amazon Studios
Brittany Runs a Marathon	Amazon Studios
Gringo	Amazon Studios
Cold War2018 Re-release	Amazon Studios
Life Itself	Amazon Studios
Honey Boy	Amazon Studios
Chi-Raq	Amazon Studios
You Were Never Really Here	Amazon Studios
Suspiria	Amazon Studios
The Salesman	Amazon Studios
Paterson	Amazon Studios
Brad's Status	Amazon Studios
The Dressmaker	Amazon Studios
The Handmaiden	Amazon Studios
The Wall	Amazon Studios
Don't Worry, He Won't Get Far on Foot	Amazon Studios
Wonder Wheel	Amazon Studios
The Neon Demon	Amazon Studios
Wonderstruck	Amazon Studios
Elvis & Nixon	Amazon Studios
Last Flag Flying	Amazon Studios
Landline	Amazon Studios
The Only Living Boy in New York	Amazon Studios
Gleason	Amazon Studios
Human Flow	Amazon Studios
Wiener-Dog	Amazon Studios
Gimme Danger	Amazon Studios
Long Strange Trip - The Untold Story of The Grateful Dead	Amazon Studios
Photograph	Amazon Studios
One Child Nation	Amazon Studios
Crown Heights	Amazon Studios
Generation Wealth	Amazon Studios
Complete Unknown	Amazon Studios
Peterloo	Amazon Studios
City of Ghosts	Amazon Studios
Author: The JT LeRoy Story	Amazon Studios
Creative Control	Amazon Studios
Earth	Disneynature
Chimpanzee	Disneynature
Oceans	Disneynature
Bears	Disneynature
Monkey Kingdom	Disneynature
African Cats	Disneynature
Born in China	Disneynature
Penguins	Disneynature
Candyman	Clive Barker
Hellraiser	Clive Barker
Candyman: Farewell to the Flesh	Clive Barker
Lord of Illusions	Clive Barker
Hellraiser III: Hell on Earth	Clive Barker
Hellbound: Hellraiser II	Clive Barker
Hellraiser: Bloodline	Clive Barker
Nightbreed	Clive Barker
The Midnight Meat Train	Clive Barker
Super Troopers 2	Broken Lizard
Beerfest	Broken Lizard
Super Troopers	Broken Lizard
Club Dread	Broken Lizard
The Slammin' Salmon	Broken Lizard
The Secret World of Arrietty	Studio Ghibli
Ponyo	Studio Ghibli
Spirited Away	Studio Ghibli
The Wind Rises	Studio Ghibli
Howl's Moving Castle	Studio Ghibli
Princess Mononoke	Studio Ghibli
Princess Mononoke2018 Re-release	Studio Ghibli
Spirited Away2019 Re-release	Studio Ghibli
Spirited Away2017 Re-release	Studio Ghibli
Spirited Away2018 Re-release	Studio Ghibli
Princess Mononoke2019 Re-release	Studio Ghibli
From Up on Poppy Hill	Studio Ghibli
The Red Turtle	Studio Ghibli
Howl's Moving Castle2019 Re-release	Studio Ghibli
The Tale of The Princess Kaguya	Studio Ghibli
Ponyo2018 Re-release	Studio Ghibli
The Cat Returns2018 Re-release	Studio Ghibli
When Marnie Was There	Studio Ghibli
Castle in the Sky2018 Re-release	Studio Ghibli
Only Yesterday2016 Re-release	Studio Ghibli
Porco Rosso2018 Re-release	Studio Ghibli
The Secret World of Arrietty2019 Re-release	Studio Ghibli
Pom Poko2018 Re-release	Studio Ghibli
The Tale of The Princess Kaguya2019 Re-release	Studio Ghibli
Ocean Waves	Studio Ghibli
Tales from Earthsea2010 Re-release	Studio Ghibli
